{
  "id": "matlab-03",
  "world": "matlab",
  "index": 3,
  "name": "Reeds & Roots",
  "objective": {
    "type": "defeatAll"
  },
  "lessonId": "matlab-arrays",
  "isBoss": false,
  "bossId": null,
  "layout": [
    "                                                                      ",
    "                                                                      ",
    "                                                                      ",
    "                                                                      ",
    "                                                                      ",
    "                                                                      ",
    "                                                                      ",
    "                                                                      ",
    "                                                                      ",
    "                                                                      ",
    "                                                                      ",
    "                                                                      ",
    "                                E                                     ",
    "                              #####                                   ",
    "                                        E                             ",
    "                        E             #####                           ",
    "                      #####                                           ",
    "                                                                      ",
    "                                                                 O    ",
    "  P     E                                             E        ####   ",
    "################   #########################   #######################",
    "################   #########################   #######################"
  ]
}