{
  "id": "matlab-01",
  "world": "matlab",
  "index": 1,
  "name": "First Steps",
  "objective": {
    "type": "reachPortal"
  },
  "lessonId": "matlab-intro",
  "isBoss": false,
  "bossId": null,
  "layout": [
    "                                                            ",
    "                                                            ",
    "                                                            ",
    "                                                            ",
    "                                                            ",
    "                                                            ",
    "                                                            ",
    "                                                            ",
    "                                                            ",
    "                                                            ",
    "                                                            ",
    "                                                            ",
    "                                                            ",
    "                                #####                       ",
    "                                                            ",
    "                        #####                               ",
    "                                        #####               ",
    "                                                            ",
    "   P            ###                                      O  ",
    "              ####### E               E           E     ### ",
    "############################################################",
    "############################################################"
  ]
}