{
  "id": "matlab-01",
  "world": "matlab",
  "index": 1,
  "name": "First Steps",
  "objective": {
    "type": "reachPortal"
  },
  "lessonId": "matlab-intro",
  "isBoss": false,
  "bossId": null,
  "layout": [
    "                                                                                    ",
    "                                                                                    ",
    "                                                                                    ",
    "                                                                                    ",
    "                                                                                    ",
    "                                                                                    ",
    "                                                                                    ",
    "                                                                                    ",
    "                                                                                    ",
    "                                                                                    ",
    "                                                                                    ",
    "                                                                                    ",
    "                                                                                    ",
    "                                                                        O           ",
    "                                                                  ###############   ",
    "                                                                                    ",
    "                                                          ======                    ",
    "                                                                                    ",
    "                                                                                    ",
    "                                      H       E                                     ",
    "                                      H#################                            ",
    "                                      H                                             ",
    "                                      H                                             ",
    "                                      H                                             ",
    "           ======                     H                                             ",
    "                                      H                                             ",
    "                                      H                                             ",
    "  P           E        E              H                                             ",
    "###############################   ##################################################",
    "###############################   ##################################################"
  ]
}
