{
  "id": "matlab-02",
  "world": "matlab",
  "index": 2,
  "name": "Marsh Path",
  "objective": {
    "type": "reachPortal"
  },
  "lessonId": "matlab-variables",
  "isBoss": false,
  "bossId": null,
  "layout": [
    "                                                                                                    ",
    "                                                                                                    ",
    "                                                                                                    ",
    "                                                                                                    ",
    "                                                                                                    ",
    "                                                                                                    ",
    "                                                                                                    ",
    "                                                                                                    ",
    "                                                                                                    ",
    "                                                                                                    ",
    "                                                                                                    ",
    "                                                                                                    ",
    "                                                                                                    ",
    "                                                                              H         E           ",
    "                                                                              H#################    ",
    "                                                                              H                     ",
    "                                                                              H                     ",
    "                                                                              H                     ",
    "                                                                              H           ======    ",
    "                                                                         E    H                     ",
    "                                                                  ###############                   ",
    "                                                                                                    ",
    "                                      ======    ======    ======                                    ",
    "                                                                                               O    ",
    "                                                                                          ##########",
    "                 H         E                                                                        ",
    "                 H#################                                                                 ",
    "                 H                                                                                  ",
    "                 H                                                                                  ",
    "                 H                                                                                  ",
    "                 H                                                                                  ",
    "                 H                                                                                  ",
    "                 H                                                                                  ",
    "  P         E    H                                                                                  ",
    "######################      #################        ###################       #####################",
    "######################      #################        ###################       #####################"
  ]
}
